Para elementos gráficos de la web
    
    1) width: ancho de un elemento o imagen. Puede definirse en píxeles (px), unidades em (em) y porcentajes (%). //Ej.: #content {width:960px;}
    2) height: altura de un elemento o imagen. Igual que la anterior. Ej.: #header {height: 250px;}
    3) background-color: color de fondo de un elemento. Se expresa en valor hexadecimal con # y seis caracteres. //Ej.: #boton {background-color: #1CBACC;}
    4) background-image: imagen de fondo para un elemento. Ej.: #content {background-image: url(«https://www.aulacm.com/fondo.jpg);}
    5) background-repeat: repetición o no de la imagen dentro del fondo (ideal para crear patterns o fondos con texturas). Se puede repetir en x (en horizontal) o en y (en vertical). //Ej.: #content {background-repeat: repeat-x;}
    6) background-position: posición de la imagen dentro del fondo. Se puede definir al centro, izquierda o derecha. También con píxeles y porcentajes. //Ej.: #content {background-position: center;}
    7) border: borde de un elemento o imagen. Tiene 3 parámetros: tipo de borde (liso, punteado, rayas, etc), grosor (expresado en píxeles) y color (expresado en valor hexadecimal). También puede definirse sin borde (none). //Ej.: #boton {border: solid 1px #000000}
    8) display: modo en que se muestra un elemento o imagen o no mostrarlo nunca. Tiene diversos valores, los más comunes son: mostrar elementos en bloque (block),
    9) z-index: posición de un elemento o imagen en el eje z (para poner elementos tapando a otros elementos)

Para textos
Las propiedades y sus atributos más comunes para modificar la apariencia de tus textos web son las siguientes:

    1) font-family: Establece una familia o fuente tipográfica.
    2) font-style: Estilo normal, cursiva u oblicua. Atributos [ normal | italic | oblique ]
    3) font-variant: Convierte las minúsculas en mayúsculas pero en tamaño menor. Atributos [ normal | small-caps ]
    4) font-weight: Grosor de la tipografía especificado en medidas de 100 a 900.
    5) font-size: tamaño o cuerpo de letra especificado en píxeles (px).
    6) text-indent: cantidad de desplazamiento lateral de la primera línea del texto, expresado en px.
    7) text-align: alineación del texto. Atributos [ left | right | center | justify ]
    8) text-decoration: aplica efectos de subrayado, tachado, parpadeo. Atributos [ none | [ underline || overline || line-through || blink ] ]
    9) letter-spacing: espaciado entre caracteres especificado en px.
    10) text-transform: para transformar los textos a mayúsculas o minúsculas [ capitalize | uppercase | lowercase | none ].
    11) line-height: interlineado entre renglones de texto expresado en px.
    12) vertical-align: alineación vertical del texto. Atributos [ baseline | sub | super | top | text-top | middle | bottom | text-bottom | <porcentaje> | <longitud> ]

Para añadir espacios o márgenes
    margin: margen a partir de un elemento hacia afuera expresado en px. Suele empujar a otros elementos cercanos
    padding: relleno o espacio interior desde el borde de un elemento hacia dentro. Ampliar padding suele arrastrar hacia fuera los bordes y por consiguiente aumenta el tamaño del elemento

    1) margin-top: margen hacia arriba
    2) margin-right: margen hacia la derecha
    3) margin-bottom: margen hacia abajo
    4) margin-left: margen hacia la izquierda
    5) padding-top: relleno desde arriba hacia adentro
    6) padding-right: relleno desde la derecha hacia adentro
    7) padding-bottom: relleno desde abajo hacia adentro
    8) padding-left: relleno desde la izquierda hacia adentro


img.(nombre de la clase) {

}

a img:hover{
    transform: scale(1.2)
}

h2:hover{
    
}